#########
#$......#
#####.###
#......@#
#########